50 27
21
3000

--------------------------------------------------
-----------+++++++++------------------------------
-----------+M------+------------+++++++++---------
-----------+-S-----+------------+-N-----+---------
-----------+-------+------------+-S-----+---------
-----------+-------+------------+N------+---------
=+++++++++++---A---+------------+----A--+---------
-------------------+------------+-------+---------
-------------------+------------+-------+---------
-------------------+------------+-------+++-------
-----+++++---------+------------+-----A---+-------
-----+-A-+---------+------------+--------S+-------
-----+---+---------+------------+---------+-------
-----+---+---------+------------+-------+++-------
-----+---+---------+------------+-------+---------
-----+---+---------+------------+------A+---------
-----+---+A-------A+------------+-------+---------
-----+---+-------S-+------------+----++++---------
-----+---+---------+------------+----+------------
-----+---+++++++++++------------+----+-A----------
-----+------------------------S-+----+-S----------
-----+-------------------------M+----+++----------
-----++++++++++++++++++++++++++++------+----------
---------------------------------------+----------
--------------------N----------N-------+----------
$+++++++++++++++++++++++++++++++++++++++----------
--------------------------------------------------
