20 13
8
1500

--------------------
=+++++++++++++++++--
----------------A+--
----++++++++++++-+--
----+N----A----+-+--
----+--+++++++-+-+--
----+--+-----+-+-+--
----+--+--A--+++-+--
----+--+--------N+--
----+--+++++++++++--
----+MSM------------
----+++++++++++++++$
--------------------
