20 8
5
750

--------------------
=++++-----------A---
---M++++++----------
--------M+++--------
-----------+--------
-----------++-------
-----A-----M+++++++$
--------------------

